NO srcs/textures/blue.xpm
SO srcs/textures/yellow.xpm
WE srcs/textures/emerald.xpm
EA srcs/textures/purple.xpm

F 50,50,50
C 3,194,252

11111111111111111111
10000000001100000001
10110000011100000001
11100100000000000001
  111111111101100001
   10000000001100001
   10111111111011101
 1110111111111011101
11000000110101011101
10000000000000001101
10000000000000001101
11000001110101011101
111101111111110111N1
11110111111111011111
10000000000000001
10111000111101111
1011100011111
1000000000001
1111111111111
