NO srcs/textures/blue.xpm
SO srcs/textures/yellow.xpm
WE srcs/textures/emerald.xpm
EA srcs/textures/purple.xpm

F 50,50,50
C 3,194,252

111111111111111
100000000000001
1000000ED000001
111111111111111